üßô‚Äç‚ôÇÔ∏è Principales personajes
Personaje	    Actor/Actriz	Pel√≠culas
Frodo Bols√≥n	Elijah Wood	    La Comunidad del Anillo, Las Dos Torres, El Retorno del Rey
Gandalf	        Ian McKellen    La Comunidad del Anillo, Las Dos Torres, El Retorno del Rey
Aragorn	        Viggo Mortensen La Comunidad del Anillo, Las Dos Torres, El Retorno del Rey
Sauron	        Sala Baker (forma f√≠sica) / Alan Howard (voz)	La Comunidad del Anillo, El Retorno del Rey
Gollum	Andy Serkis	Las Dos Torres, El Retorno del Rey
Legolas	Orlando Bloom	La Comunidad del Anillo, Las Dos Torres, El Retorno del Rey
Galadriel	Cate Blanchett	La Comunidad del Anillo, Las Dos Torres (versi√≥n extendida), El Retorno del Rey
Arwen	Liv Tyler	La Comunidad del Anillo, Las Dos Torres, El Retorno del Rey
Bilbo Bols√≥n	Ian Holm	La Comunidad del Anillo, El Retorno del Rey
Gimli	John Rhys-Davies	La Comunidad del Anillo, Las Dos Torres, El Retorno del Rey
Balrog	Sala Baker (movimientos) / Frank Welker (voz)	La Comunidad del Anillo
Elrond	Hugo Weaving	La Comunidad del Anillo, Las Dos Torres, El Retorno del Rey
Peregrin ‚ÄúPippin‚Äù Tuk	Billy Boyd	La Comunidad del Anillo, Las Dos Torres, El Retorno del Rey
Meriadoc ‚ÄúMerry‚Äù Brandigamo	Dominic Monaghan	La Comunidad del Anillo, Las Dos Torres, El Retorno del Rey
Samsagaz ‚ÄúSam‚Äù Gamyi	Sean Astin	La Comunidad del Anillo, Las Dos Torres, El Retorno del Rey
‚öîÔ∏è Rohan y Gondor
Personaje	Actor/Actriz	Pel√≠culas
Th√©oden	Bernard Hill	Las Dos Torres, El Retorno del Rey
√âowyn	Miranda Otto	Las Dos Torres, El Retorno del Rey
√âomer	Karl Urban	Las Dos Torres, El Retorno del Rey
Faramir	David Wenham	Las Dos Torres, El Retorno del Rey
Boromir	Sean Bean	La Comunidad del Anillo, (flashback en Las Dos Torres)
Denethor II	John Noble	El Retorno del Rey
Gr√≠ma (Lengua de Serpiente)	Brad Dourif	Las Dos Torres, El Retorno del Rey
Gamling	Bruce Hopkins	Las Dos Torres, El Retorno del Rey
Th√©odred	Paris Howe Strewe	Las Dos Torres
Brego (caballo)	interpretado por varios caballos entrenados	Las Dos Torres, El Retorno del Rey
Forlong	Lorrie Darragh	El Retorno del Rey
Bergil	Harry Sinclair (sin acreditar, versi√≥n extendida)	El Retorno del Rey
üå≥ Otros seres y razas
Personaje	Actor/Actriz	Pel√≠culas
Barbol (Treebeard)	Voz: John Rhys-Davies	Las Dos Torres, El Retorno del Rey
Shelob (Ella-Lara√±a)	Animaci√≥n CGI (voz y efectos por un equipo de sonido)	El Retorno del Rey
Lord of the Nazg√ªl / Witch-King	Lawrence Makoare (cuerpo) / Andy Serkis (voz en parte)	Las Dos Torres, El Retorno del Rey
Celeborn	Marton Csokas	La Comunidad del Anillo
The Mouth of Sauron (La Boca de Sauron)	Bruce Spence	El Retorno del Rey (versi√≥n extendida)
Radagast	‚Äî (no aparece en la trilog√≠a, solo en El Hobbit)	‚Äî
‚öîÔ∏è Adicionales que faltaban
Personaje	Actor/Actriz	Pel√≠culas
Isildur	Harry Sinclair	La Comunidad del Anillo (pr√≥logo), El Retorno del Rey (flashback)
Haldir	Craig Parker	La Comunidad del Anillo, Las Dos Torres
Rey de los Muertos	Paul Norell	El Retorno del Rey
Grishn√°kh	Stephen Ure	Las Dos Torres
Ugl√∫k	Nathaniel Lees	Las Dos Torres
Lurtz	Lawrence Makoare	La Comunidad del Anillo